                                                                                                                                                
                                                                                                                                                
                                                                                     ╭─╮           ╭─╮           ╭─╮           ╭─╮           ╭──
                                                                                     │#│           │#│           │#│           │#│           │##
                                                                                   ╭─╯#│         ╭─╯#│         ╭─╯#│         ╭─╯#│         ╭─╯##
                                                                                   │###│         │###│         │###│         │###│         │####
                                                                                 ╭─╯###│       ╭─╯###│       ╭─╯###│       ╭─╯###│       ╭─╯####
                                                                                 │#####│       │#####│       │#####│       │#####│       │######
                                                                               ╭─╯#####│     ╭─╯#####│     ╭─╯#####│     ╭─╯#####│     ╭─╯######
 START                                                                         │#######│     │#######│     │#######│     │#######│     │########
                                                                             ╭─╯#######│   ╭─╯#######│   ╭─╯#######│   ╭─╯#######│   ╭─╯########
                                                                             │#########│   │#########│   │#########│   │#########│   │##########
─────────────────────────────────────────────────────────────────────────────╯#########╰───╯#########╰───╯#########╰───╯#########╰───╯##########
################################################################################################################################################
################################################################################################################################################
################################################################################################################################################
################################################################################################################################################
################################################################################################################################################
################################################################################################################################################
################################################################################################################################################
################################################################################################################################################
