                                                                                                                                                                  
                                                                                                                                                                  
                                                                                                                                                                  
                                                                                 #         #         #         #         #         #         #         #         #
                                                                                ##        ##        ##        ##        ##        ##        ##        ##        ##
                                                                               ###       ###       ###       ###       ###       ###       ###       ###       ###
                                                                              ####      ####      ####      ####      ####      ####      ####      ####      ####
                                                                             #####     #####     #####     #####     #####     #####     #####     #####     #####
                                                                            ######    ######    ######    ######    ######    ######    ######    ######    ######
START                                                                      #######   #######   #######   #######   #######   #######   #######   #######   #######
                                                                          ########  ########  ########  ########  ########  ########  ########  ########  ########
                                                                         ######### ######### ######### ######### ######### ######### ######### ######### #########
##################################################################################################################################################################
##################################################################################################################################################################
##################################################################################################################################################################
##################################################################################################################################################################
##################################################################################################################################################################
##################################################################################################################################################################
##################################################################################################################################################################
##################################################################################################################################################################
##################################################################################################################################################################
